000#000#0000####
000D000D0000####
000#000#0000####
#####D##########
###0000#000#####
###0000D000#####
###0000#000#####
####D######0000#
###00000###0000#
###00000###0000#
###00000###0000#
#####D#######D##
####000#000#000#
####000D000D000#
####000#000#000#
################