000#000#0000####
000000000000####
000#000#0000####
#####0##########
###0000#000#####
###00000000#####
###0000#000#####
####0######0000#
###00000###0000#
###00000###0000#
###00000###0000#
#####0#######0##
####000#000#000#
####00000000000#
####000#000#000#
################